//MAP CONVERTED BY dmm2tgm.py THIS HEADER COMMENT PREVENTS RECONVERSION, DO NOT REMOVE
"aw" = (
/obj/effect/turf_decal/tile/neutral/half,
/turf/open/floor/plasteel,
/area/shuttle/ruin/bigderelict/outpost)
"bK" = (
/obj/effect/turf_decal/stripes/yellow/line{
	dir = 9
	},
/obj/effect/decal/cleanable/dirt,
/obj/item/storage/toolbox/emergency,
/obj/structure/table/reinforced,
/obj/item/wrench,
/turf/open/floor/mineral/titanium/tiled/white,
/area/shuttle/ruin/bigderelict/outpost)
"co" = (
/obj/effect/turf_decal/stripes/yellow/line{
	dir = 8
	},
/obj/effect/decal/cleanable/dirt,
/obj/structure/closet/secure_closet/medical1,
/obj/item/storage/firstaid/regular,
/turf/open/floor/mineral/titanium/tiled/white,
/area/shuttle/ruin/bigderelict/outpost)
"cK" = (
/obj/machinery/computer/shuttle/outpost_shuttle{
	dir = 8
	},
/turf/open/floor/plasteel,
/area/shuttle/ruin/bigderelict/outpost)
"cX" = (
/obj/effect/decal/cleanable/dirt,
/obj/effect/turf_decal/tile/neutral{
	dir = 1
	},
/obj/effect/turf_decal/tile/neutral,
/obj/effect/turf_decal/tile/neutral{
	dir = 4
	},
/obj/effect/turf_decal/tile/neutral{
	dir = 8
	},
/turf/open/floor/plasteel,
/area/shuttle/ruin/bigderelict/outpost)
"dj" = (
/obj/effect/mapping_helpers/airlock/cyclelink_helper{
	dir = 1
	},
/obj/structure/fans/tiny,
/obj/machinery/door/airlock/external/abandoned_brown,
/turf/open/floor/plating,
/area/shuttle/ruin/bigderelict/outpost)
"dm" = (
/obj/effect/turf_decal/stripes/yellow/line{
	dir = 10
	},
/obj/effect/decal/cleanable/dirt,
/obj/structure/closet/secure_closet/medical1,
/obj/item/storage/firstaid/brute,
/turf/open/floor/mineral/titanium/tiled/white,
/area/shuttle/ruin/bigderelict/outpost)
"ds" = (
/obj/structure/chair/comfy/shuttle{
	dir = 4
	},
/obj/effect/turf_decal/tile/neutral/half{
	dir = 8
	},
/turf/open/floor/plasteel,
/area/shuttle/ruin/bigderelict/outpost)
"dR" = (
/obj/structure/shuttle/engine/heater{
	dir = 8
	},
/obj/structure/window/reinforced{
	dir = 4
	},
/turf/open/floor/plating/airless,
/area/shuttle/ruin/bigderelict/outpost)
"dW" = (
/obj/machinery/power/smes{
	charge = 5e+006
	},
/obj/effect/turf_decal/stripes/yellow/line{
	dir = 5
	},
/obj/structure/cable/yellow{
	icon_state = "0-4"
	},
/obj/effect/decal/cleanable/dirt,
/obj/effect/decal/cleanable/dirt,
/turf/open/floor/plating,
/area/shuttle/ruin/bigderelict/outpost)
"el" = (
/obj/machinery/airalarm/syndicate{
	dir = 4;
	pixel_x = -24
	},
/obj/effect/decal/cleanable/dirt,
/turf/open/floor/plasteel,
/area/shuttle/ruin/bigderelict/outpost)
"et" = (
/obj/effect/turf_decal/tile/neutral/half{
	dir = 1
	},
/turf/open/floor/plasteel,
/area/shuttle/ruin/bigderelict/outpost)
"fx" = (
/obj/machinery/porta_turret/syndicate/energy{
	dir = 1;
	icon_state = "standard_lethal";
	mode = 1;
	faction = list("InteQ")
	},
/turf/closed/wall/mineral/titanium/nodiagonal,
/area/shuttle/ruin/bigderelict/outpost)
"gu" = (
/turf/closed/wall/mineral/titanium/nodiagonal,
/area/shuttle/ruin/bigderelict/outpost)
"lb" = (
/obj/structure/chair/comfy/shuttle{
	dir = 1
	},
/obj/effect/decal/cleanable/dirt,
/obj/structure/sign/warning/vacuum{
	pixel_y = -32
	},
/obj/effect/turf_decal/stripes/yellow/line{
	dir = 4
	},
/turf/open/floor/pod/dark,
/area/shuttle/ruin/bigderelict/outpost)
"mw" = (
/obj/structure/table/reinforced,
/obj/item/storage/firstaid/regular,
/obj/item/assembly/flash/handheld,
/obj/structure/sign/warning/vacuum{
	pixel_y = -32
	},
/turf/open/floor/plasteel,
/area/shuttle/ruin/bigderelict/outpost)
"no" = (
/obj/machinery/firealarm{
	dir = 8;
	pixel_x = -24
	},
/obj/effect/decal/cleanable/dirt,
/turf/open/floor/plasteel,
/area/shuttle/ruin/bigderelict/outpost)
"oI" = (
/obj/structure/chair/comfy/shuttle{
	dir = 1
	},
/obj/machinery/light/small{
	dir = 8
	},
/obj/effect/decal/cleanable/dirt,
/obj/machinery/firealarm{
	dir = 1;
	pixel_y = -26
	},
/turf/open/floor/pod/dark,
/area/shuttle/ruin/bigderelict/outpost)
"oW" = (
/obj/structure/chair/comfy/shuttle{
	dir = 4
	},
/turf/open/floor/plasteel,
/area/shuttle/ruin/bigderelict/outpost)
"qs" = (
/obj/machinery/airalarm/syndicate{
	dir = 4;
	pixel_x = -24
	},
/turf/open/floor/plasteel,
/area/shuttle/ruin/bigderelict/outpost)
"qW" = (
/obj/effect/turf_decal/stripes/yellow/line{
	dir = 9
	},
/obj/structure/closet/secure_closet/medical1,
/obj/item/storage/firstaid/regular{
	empty = 1;
	name = "First-Aid (empty)"
	},
/turf/open/floor/mineral/titanium/tiled/white,
/area/shuttle/ruin/bigderelict/outpost)
"qZ" = (
/obj/effect/turf_decal/tile/neutral{
	dir = 1
	},
/obj/effect/turf_decal/tile/neutral,
/obj/effect/turf_decal/tile/neutral{
	dir = 4
	},
/obj/effect/turf_decal/tile/neutral{
	dir = 8
	},
/turf/open/floor/plasteel,
/area/shuttle/ruin/bigderelict/outpost)
"sg" = (
/obj/effect/mapping_helpers/airlock/cyclelink_helper{
	dir = 4
	},
/obj/effect/turf_decal/tile/neutral{
	dir = 1
	},
/obj/effect/turf_decal/tile/neutral,
/obj/effect/turf_decal/tile/neutral{
	dir = 4
	},
/obj/effect/turf_decal/tile/neutral{
	dir = 8
	},
/obj/machinery/door/airlock/external/abandoned_brown,
/turf/open/floor/plasteel/dark,
/area/shuttle/ruin/bigderelict/outpost)
"tH" = (
/obj/machinery/firealarm{
	dir = 8;
	pixel_x = -24
	},
/turf/open/floor/plasteel,
/area/shuttle/ruin/bigderelict/outpost)
"uj" = (
/obj/machinery/light/small{
	dir = 8
	},
/obj/machinery/button/door{
	id = "caravansyndicate3_bolt_starboard";
	name = "External Bolt Control";
	normaldoorcontrol = 1;
	pixel_x = -24;
	pixel_y = -6;
	req_access_txt = "150";
	specialfunctions = 4
	},
/turf/open/floor/plasteel,
/area/shuttle/ruin/bigderelict/outpost)
"us" = (
/obj/machinery/porta_turret/syndicate/energy{
	dir = 2;
	icon_state = "standard_lethal";
	mode = 1;
	faction = list("InteQ")
	},
/turf/closed/wall/mineral/titanium/nodiagonal,
/area/shuttle/ruin/bigderelict/outpost)
"vE" = (
/obj/machinery/light/small{
	dir = 8
	},
/obj/effect/decal/cleanable/dirt,
/obj/effect/decal/cleanable/dirt,
/obj/effect/turf_decal/stripes/yellow/line,
/turf/open/floor/plasteel,
/area/shuttle/ruin/bigderelict/outpost)
"wd" = (
/obj/effect/turf_decal/tile/neutral{
	dir = 1
	},
/obj/effect/turf_decal/tile/neutral,
/obj/effect/turf_decal/tile/neutral{
	dir = 4
	},
/obj/effect/turf_decal/tile/neutral{
	dir = 8
	},
/obj/effect/turf_decal/stripes/yellow/line,
/turf/open/floor/plasteel,
/area/shuttle/ruin/bigderelict/outpost)
"wg" = (
/obj/structure/chair/comfy/shuttle,
/obj/effect/decal/cleanable/dirt,
/obj/structure/sign/warning/vacuum{
	pixel_y = 32
	},
/obj/effect/turf_decal/stripes/yellow/line{
	dir = 4
	},
/turf/open/floor/pod/dark,
/area/shuttle/ruin/bigderelict/outpost)
"xa" = (
/obj/effect/turf_decal/stripes/yellow/line{
	dir = 10
	},
/obj/structure/closet/secure_closet/medical1,
/obj/item/storage/firstaid/regular{
	empty = 1;
	name = "First-Aid (empty)"
	},
/turf/open/floor/mineral/titanium/tiled/white,
/area/shuttle/ruin/bigderelict/outpost)
"yb" = (
/obj/effect/turf_decal/stripes/yellow/line{
	dir = 4
	},
/obj/structure/closet/crate,
/obj/machinery/power/terminal{
	dir = 1
	},
/obj/structure/cable{
	icon_state = "0-2"
	},
/obj/item/stack/sheet/metal/twenty,
/obj/item/stack/sheet/glass{
	amount = 10
	},
/obj/item/stack/sheet/mineral/plastitanium{
	amount = 20
	},
/obj/item/storage/box/lights/bulbs,
/obj/item/storage/toolbox/mechanical,
/obj/item/stack/sheet/mineral/plasma{
	amount = 20
	},
/turf/open/floor/plating,
/area/shuttle/ruin/bigderelict/outpost)
"yA" = (
/obj/machinery/light/small{
	dir = 8
	},
/obj/machinery/button/door{
	id = "caravansyndicate3_bolt_port";
	name = "External Bolt Control";
	normaldoorcontrol = 1;
	pixel_x = -24;
	pixel_y = 6;
	req_access_txt = "150";
	specialfunctions = 4
	},
/mob/living/simple_animal/hostile/netherworld/blankbody,
/turf/open/floor/plasteel,
/area/shuttle/ruin/bigderelict/outpost)
"Bw" = (
/obj/effect/turf_decal/stripes/yellow/line{
	dir = 8
	},
/obj/machinery/light/small{
	dir = 4
	},
/obj/effect/decal/cleanable/dirt,
/obj/effect/decal/cleanable/dirt,
/obj/item/storage/toolbox/emergency,
/obj/structure/table/reinforced,
/turf/open/floor/mineral/titanium/tiled/white,
/area/shuttle/ruin/bigderelict/outpost)
"Dn" = (
/obj/structure/cable/yellow{
	icon_state = "1-8"
	},
/obj/effect/decal/cleanable/dirt,
/obj/effect/turf_decal/tile/neutral/half{
	dir = 1
	},
/turf/open/floor/plasteel,
/area/shuttle/ruin/bigderelict/outpost)
"Eh" = (
/obj/effect/turf_decal/tile/neutral/half{
	dir = 4
	},
/turf/open/floor/plasteel,
/area/shuttle/ruin/bigderelict/outpost)
"EY" = (
/obj/effect/decal/cleanable/dirt,
/obj/machinery/computer/crew{
	dir = 8
	},
/turf/open/floor/plasteel,
/area/shuttle/ruin/bigderelict/outpost)
"Fy" = (
/obj/structure/grille,
/obj/machinery/door/poddoor{
	id = "caravansyndicate3_bridge"
	},
/obj/structure/window/shuttle,
/turf/open/floor/plating,
/area/shuttle/ruin/bigderelict/outpost)
"FC" = (
/turf/template_noop,
/area/template_noop)
"Gn" = (
/obj/structure/shuttle/engine/propulsion/burst/left{
	dir = 8
	},
/turf/open/floor/plating/airless,
/area/shuttle/ruin/bigderelict/outpost)
"Hz" = (
/obj/effect/turf_decal/stripes/yellow/line{
	dir = 8
	},
/obj/machinery/light/small{
	dir = 4
	},
/obj/structure/closet/secure_closet/medical1,
/obj/item/storage/firstaid/regular{
	empty = 1;
	name = "First-Aid (empty)"
	},
/turf/open/floor/mineral/titanium/tiled/white,
/area/shuttle/ruin/bigderelict/outpost)
"Ia" = (
/obj/structure/shuttle/engine/propulsion/burst/right{
	dir = 8
	},
/turf/open/floor/plating/airless,
/area/shuttle/ruin/bigderelict/outpost)
"Jt" = (
/obj/effect/mapping_helpers/airlock/cyclelink_helper,
/obj/structure/fans/tiny,
/obj/machinery/door/airlock/external/abandoned_brown,
/obj/effect/mapping_helpers/airlock/locked,
/obj/docking_port/mobile{
	callTime = 150;
	dir = 2;
	dwidth = 6;
	height = 7;
	shuttle_id = "outpostshuttle";
	movement_force = list("KNOCKDOWN" = 0, "THROW" = 0);
	name = "Outpost shuttle";
	port_direction = 8;
	preferred_direction = 4;
	width = 15
	},
/turf/open/floor/plating,
/area/shuttle/ruin/bigderelict/outpost)
"JL" = (
/obj/structure/chair/comfy/shuttle,
/obj/machinery/light/small{
	dir = 8
	},
/obj/structure/cable/yellow{
	icon_state = "0-2"
	},
/obj/machinery/power/apc/syndicate{
	dir = 8;
	name = "Syndicate Drop Ship APC";
	pixel_x = -25
	},
/obj/effect/decal/cleanable/dirt,
/obj/machinery/airalarm/syndicate{
	pixel_y = 24
	},
/turf/open/floor/pod/dark,
/area/shuttle/ruin/bigderelict/outpost)
"Kf" = (
/turf/closed/wall/mineral/titanium,
/area/shuttle/ruin/bigderelict/outpost)
"MU" = (
/obj/structure/table/reinforced,
/obj/machinery/button/door{
	id = "caravansyndicate3_bridge";
	name = "Bridge Blast Door Control";
	pixel_x = -24;
	pixel_y = 5;
	req_access_txt = "150"
	},
/obj/machinery/button/door{
	id = "caravansyndicate3_bolt_bridge";
	name = "Bridge Bolt Control";
	normaldoorcontrol = 1;
	pixel_x = -24;
	pixel_y = -5;
	req_access_txt = "150";
	specialfunctions = 4
	},
/obj/effect/decal/cleanable/dirt,
/turf/open/floor/plasteel,
/area/shuttle/ruin/bigderelict/outpost)
"Nl" = (
/obj/effect/turf_decal/stripes/yellow/line{
	dir = 6
	},
/obj/structure/cable,
/obj/machinery/power/port_gen/pacman{
	anchored = 1
	},
/obj/item/wrench,
/obj/effect/decal/cleanable/dirt,
/turf/open/floor/plating,
/area/shuttle/ruin/bigderelict/outpost)
"Tx" = (
/obj/machinery/turretid{
	ailock = 1;
	control_area = null;
	desc = "A specially designed set of turret controls. Looks to be covered in protective casing to prevent AI interfacing.";
	icon_state = "control_kill";
	lethal = 1;
	name = "Shuttle turret control";
	pixel_y = 34;
	req_access = null;
	req_access_txt = "150"
	},
/obj/structure/chair/comfy/shuttle{
	dir = 4
	},
/mob/living/simple_animal/hostile/netherworld/migo,
/turf/open/floor/plasteel,
/area/shuttle/ruin/bigderelict/outpost)
"Vo" = (
/obj/effect/turf_decal/tile/neutral{
	dir = 1
	},
/obj/effect/turf_decal/tile/neutral,
/obj/effect/turf_decal/tile/neutral{
	dir = 4
	},
/obj/effect/turf_decal/tile/neutral{
	dir = 8
	},
/mob/living/simple_animal/hostile/netherworld/blankbody,
/turf/open/floor/plasteel,
/area/shuttle/ruin/bigderelict/outpost)
"Xq" = (
/obj/structure/shuttle/engine/propulsion/burst{
	dir = 8
	},
/turf/open/floor/plating/airless,
/area/shuttle/ruin/bigderelict/outpost)
"Xz" = (
/obj/effect/decal/cleanable/dirt,
/obj/machinery/computer/camera_advanced/shuttle_docker/outpost_shuttle{
	dir = 8
	},
/turf/open/floor/plasteel,
/area/shuttle/ruin/bigderelict/outpost)
"YZ" = (
/obj/structure/table/reinforced,
/obj/machinery/recharger{
	pixel_x = -2;
	pixel_y = 0
	},
/obj/machinery/light/small{
	dir = 8
	},
/turf/open/floor/plasteel,
/area/shuttle/ruin/bigderelict/outpost)
"Zr" = (
/obj/effect/mapping_helpers/airlock/locked,
/obj/effect/mapping_helpers/airlock/cyclelink_helper{
	dir = 8
	},
/obj/effect/turf_decal/tile/neutral{
	dir = 1
	},
/obj/effect/turf_decal/tile/neutral,
/obj/effect/turf_decal/tile/neutral{
	dir = 4
	},
/obj/effect/turf_decal/tile/neutral{
	dir = 8
	},
/obj/machinery/door/airlock/external/abandoned_brown,
/turf/open/floor/plasteel/dark,
/area/shuttle/ruin/bigderelict/outpost)
"ZZ" = (
/obj/effect/turf_decal/tile/neutral{
	dir = 1
	},
/obj/effect/turf_decal/tile/neutral,
/obj/effect/turf_decal/tile/neutral{
	dir = 4
	},
/obj/effect/turf_decal/tile/neutral{
	dir = 8
	},
/obj/effect/turf_decal/stripes/yellow/line{
	dir = 1
	},
/turf/open/floor/plasteel,
/area/shuttle/ruin/bigderelict/outpost)

(1,1,1) = {"
FC
Gn
Xq
Xq
Xq
Ia
FC
"}
(2,1,1) = {"
Kf
dR
dR
dR
dR
dR
Kf
"}
(3,1,1) = {"
gu
gu
dW
yb
Nl
gu
gu
"}
(4,1,1) = {"
gu
JL
Dn
Eh
aw
oI
gu
"}
(5,1,1) = {"
gu
wg
et
qZ
aw
lb
gu
"}
(6,1,1) = {"
Jt
ZZ
qZ
qZ
qZ
wd
dj
"}
(7,1,1) = {"
fx
Hz
dm
qZ
bK
Bw
us
"}
(8,1,1) = {"
gu
gu
gu
sg
gu
gu
gu
"}
(9,1,1) = {"
gu
yA
el
Vo
tH
uj
gu
"}
(10,1,1) = {"
gu
co
xa
cX
qW
co
gu
"}
(11,1,1) = {"
gu
gu
gu
Zr
gu
gu
gu
"}
(12,1,1) = {"
gu
YZ
qs
qZ
no
vE
dj
"}
(13,1,1) = {"
gu
MU
Tx
ds
oW
mw
gu
"}
(14,1,1) = {"
Fy
Fy
EY
cK
Xz
Fy
Fy
"}
(15,1,1) = {"
FC
Fy
Fy
Fy
Fy
Fy
FC
"}
